NO textures/coin.xpm
SO textures/door.xpm

WE textures/player.xpm

EA textures/wall.xpm


F 184,113,39
C 51,198,227

1111111111111111111111111111111111
1000000000000000000000000000000001
1010010100100000101001000000010101
1010010010101010001001000000010101
1S00000000000000000000000000000001
1111111111111111111111111111111111


